1985,1116,1234,09,08,1
1985,1120,1345,11,06,5
1985,1207,1250,01,16,-15
1985,1229,1425,09,08,1
1985,1242,1325,03,14,-11
1985,1246,1449,12,05,7
1985,1256,1338,05,12,-7
1985,1260,1233,04,13,-9
1985,1314,1292,02,15,-13
1985,1323,1333,07,10,-3
1985,1326,1235,04,13,-9
1985,1328,1299,01,16,-15
1985,1374,1330,05,12,-7
1985,1385,1380,01,16,-15
1985,1396,1439,08,09,-1
1985,1424,1361,04,13,-9
1985,1104,1112,07,10,-3
1985,1130,1403,11,06,5
1985,1181,1337,03,14,-11
1985,1208,1455,06,11,-5
1985,1210,1273,02,15,-13
1985,1228,1318,03,14,-11
1985,1268,1275,05,12,-7
1985,1272,1335,02,15,-13
1985,1276,1192,01,16,-15
1985,1298,1261,13,04,9
1985,1301,1305,03,14,-11
1985,1393,1177,07,10,-3
1985,1412,1277,07,10,-3
1985,1431,1409,11,06,5
1985,1433,1267,02,15,-13
1985,1437,1173,08,09,-1
1985,1120,1242,11,03,8
1985,1207,1396,01,08,-7
1985,1246,1424,12,04,8
1985,1256,1326,05,04,1
1985,1260,1374,04,05,-1
1985,1314,1323,02,07,-5
1985,1328,1229,01,09,-8
1985,1385,1116,01,09,-8
1985,1104,1433,07,02,5
1985,1130,1181,11,03,8
1985,1210,1393,02,07,-5
1985,1228,1208,03,06,-3
1985,1268,1298,05,13,-8
1985,1272,1412,02,07,-5
1985,1301,1431,03,11,-8
1985,1437,1276,08,01,7
1985,1207,1260,01,04,-3
1985,1210,1228,02,03,-1
1985,1272,1130,02,11,-9
1985,1328,1256,01,05,-4
1985,1301,1104,03,07,-4
1985,1314,1120,02,11,-9
1985,1385,1246,01,12,-11
1985,1437,1268,08,05,3
1985,1207,1210,01,02,-1
1985,1272,1328,02,01,1
1985,1385,1301,01,03,-2
1985,1437,1314,08,02,6
1985,1207,1385,01,01,0
1985,1437,1272,08,02,6
1985,1437,1207,08,01,7
1986,1133,1431,07,10,-3
1986,1177,1438,12,05,7
1986,1181,1290,01,16,-15
1986,1207,1403,04,13,-9
1986,1210,1265,02,15,-13
1986,1242,1299,01,16,-15
1986,1257,1180,02,15,-13
1986,1261,1345,11,06,5
1986,1272,1123,03,14,-11
1986,1277,1449,05,12,-7
1986,1314,1428,03,14,-11
1986,1328,1318,04,13,-9
1986,1330,1452,08,09,-1
1986,1396,1239,09,08,1
1986,1412,1281,06,11,-5
1986,1437,1439,10,07,3
1986,1104,1462,05,12,-7
1986,1114,1323,14,03,11
1986,1120,1112,08,09,-1
1986,1156,1231,14,03,11
1986,1228,1193,04,13,-9
1986,1235,1275,07,10,-3
1986,1246,1172,01,16,-15
1986,1268,1337,05,12,-7
1986,1276,1103,02,15,-13
1986,1298,1409,07,10,-3
1986,1301,1234,06,11,-5
1986,1385,1286,01,16,-15
1986,1386,1350,06,11,-5
1986,1393,1135,02,15,-13
1986,1424,1419,04,13,-9
1986,1443,1304,08,09,-1
1986,1177,1328,12,04,8
1986,1181,1330,01,08,-7
1986,1210,1437,02,10,-8
1986,1242,1396,01,09,-8
1986,1257,1133,02,07,-5
1986,1261,1272,11,03,8
1986,1277,1207,05,04,1
1986,1314,1412,03,06,-3
1986,1104,1228,05,04,1
1986,1120,1385,08,01,7
1986,1156,1386,14,06,8
1986,1235,1276,07,02,5
1986,1246,1443,01,08,-7
1986,1298,1393,07,02,5
1986,1301,1114,06,14,-8
1986,1424,1268,04,05,-1
1986,1120,1424,08,04,4
1986,1246,1104,01,05,-4
1986,1257,1314,02,03,-1
1986,1261,1210,11,02,9
1986,1181,1177,01,12,-11
1986,1242,1277,01,05,-4
1986,1298,1156,07,14,-7
1986,1301,1235,06,07,-1
1986,1257,1120,02,08,-6
1986,1261,1246,11,01,10
1986,1181,1298,01,07,-6
1986,1242,1301,01,06,-5
1986,1181,1242,01,01,0
1986,1257,1261,02,11,-9
1986,1257,1181,02,01,1
1987,1104,1299,02,15,-13
1987,1120,1360,08,09,-1
1987,1122,1228,14,03,11
1987,1181,1401,05,12,-7
1987,1231,1193,01,16,-15
1987,1243,1208,09,08,1
1987,1276,1298,09,08,1
1987,1309,1140,07,10,-3
1987,1314,1335,01,16,-15
1987,1323,1292,05,12,-7
1987,1344,1412,06,11,-5
1987,1395,1267,04,13,-9
1987,1417,1141,04,13,-9
1987,1424,1226,01,16,-15
1987,1461,1438,12,05,7
1987,1462,1281,13,04,9
1987,1177,1256,03,14,-11
1987,1196,1301,06,11,-5
1987,1207,1137,01,16,-15
1987,1234,1365,02,15,-13
1987,1242,1222,05,12,-7
1987,1261,1210,10,07,3
1987,1283,1155,13,04,9
1987,1326,1246,09,08,1
1987,1328,1409,06,11,-5
1987,1338,1265,03,14,-11
1987,1345,1318,03,14,-11
1987,1385,1455,06,11,-5
1987,1393,1204,02,15,-13
1987,1396,1380,02,15,-13
1987,1431,1112,07,10,-3
1987,1443,1452,10,07,3
1987,1104,1309,02,07,-5
1987,1181,1462,05,13,-8
1987,1231,1120,01,08,-7
1987,1314,1276,01,09,-8
1987,1323,1395,05,04,1
1987,1344,1122,06,14,-8
1987,1424,1243,01,09,-8
1987,1461,1417,12,04,8
1987,1177,1385,03,06,-3
1987,1196,1345,06,03,3
1987,1207,1326,01,09,-8
1987,1234,1431,02,07,-5
1987,1242,1283,05,13,-8
1987,1261,1396,10,02,8
1987,1328,1338,06,03,3
1987,1393,1443,02,10,-8
1987,1207,1242,01,05,-4
1987,1314,1323,01,05,-4
1987,1344,1104,06,02,4
1987,1393,1196,02,06,-4
1987,1231,1181,01,05,-4
1987,1234,1328,02,06,-4
1987,1261,1177,10,03,7
1987,1424,1461,01,12,-11
1987,1344,1207,06,01,5
1987,1393,1314,02,01,1
1987,1231,1261,01,10,-9
1987,1424,1234,01,02,-1
1987,1231,1424,01,01,0
1987,1393,1344,02,06,-4
1987,1231,1393,01,02,-1
1988,1120,1133,08,09,-1
1988,1140,1150,04,13,-9
1988,1177,1455,05,12,-7
1988,1181,1131,02,15,-13
1988,1196,1385,06,11,-5
1988,1243,1247,04,13,-9
1988,1257,1333,05,12,-7
1988,1258,1461,10,07,3
1988,1272,1124,09,08,1
1988,1276,1129,03,14,-11
1988,1314,1317,02,15,-13
1988,1328,1151,01,16,-15
1988,1345,1192,01,16,-15
1988,1348,1281,11,06,5
1988,1374,1323,07,10,-3
1988,1393,1299,03,14,-11
1988,1112,1165,01,16,-15
1988,1207,1261,08,09,-1
1988,1210,1235,05,12,-7
1988,1228,1427,03,14,-11
1988,1234,1199,05,12,-7
1988,1242,1462,06,11,-5
1988,1246,1380,02,15,-13
1988,1268,1364,07,10,-3
1988,1293,1301,14,03,11
1988,1338,1185,02,15,-13
1988,1350,1231,13,04,9
1988,1371,1431,08,09,-1
1988,1396,1250,01,16,-15
1988,1424,1283,04,13,-9
1988,1435,1429,07,10,-3
1988,1437,1116,06,11,-5
1988,1181,1374,02,07,-5
1988,1243,1177,04,05,-1
1988,1257,1140,05,04,1
1988,1276,1196,03,06,-3
1988,1314,1258,02,10,-8
1988,1328,1120,01,08,-7
1988,1345,1272,01,09,-8
1988,1348,1393,11,03,8
1988,1112,1371,01,08,-7
1988,1234,1424,05,04,1
1988,1242,1293,06,14,-8
1988,1246,1268,02,07,-5
1988,1350,1210,13,05,8
1988,1396,1207,01,08,-7
1988,1435,1338,07,02,5
1988,1437,1228,06,03,3
1988,1181,1348,02,11,-9
1988,1328,1257,01,05,-4
1988,1396,1350,01,13,-12
1988,1437,1246,06,02,4
1988,1112,1234,01,05,-4
1988,1242,1435,06,07,-1
1988,1243,1345,04,01,3
1988,1314,1276,02,03,-1
1988,1181,1396,02,01,1
1988,1328,1437,01,06,-5
1988,1112,1314,01,02,-1
1988,1242,1243,06,04,2
1988,1242,1181,06,02,4
1988,1328,1112,01,01,0
1988,1242,1328,06,01,5
1989,1112,1352,01,16,-15
1989,1116,1258,05,12,-7
1989,1123,1338,09,08,1
1989,1155,1388,09,08,1
1989,1177,1272,12,05,7
1989,1181,1354,02,15,-13
1989,1228,1270,01,16,-15
1989,1256,1247,09,08,1
1989,1257,1114,04,13,-9
1989,1278,1243,11,06,5
1989,1292,1199,13,04,9
1989,1328,1190,01,16,-15
1989,1373,1390,14,03,11
1989,1424,1225,04,13,-9
1989,1438,1344,05,12,-7
1989,1452,1397,07,10,-3
1989,1161,1196,10,07,3
1989,1191,1333,11,06,5
1989,1207,1343,01,16,-15
1989,1231,1206,02,15,-13
1989,1234,1353,04,13,-9
1989,1276,1462,03,14,-11
1989,1281,1166,03,14,-11
1989,1301,1376,05,12,-7
1989,1314,1380,02,15,-13
1989,1323,1435,09,08,1
1989,1371,1283,03,14,-11
1989,1375,1104,11,06,5
1989,1393,1137,02,15,-13
1989,1400,1210,11,06,5
1989,1417,1235,07,10,-3
1989,1431,1261,07,10,-3
1989,1112,1155,01,09,-8
1989,1181,1452,02,07,-5
1989,1228,1123,01,09,-8
1989,1257,1116,04,05,-1
1989,1278,1373,11,14,-3
1989,1328,1256,01,09,-8
1989,1424,1177,04,12,-8
1989,1438,1292,05,13,-8
1989,1207,1323,01,09,-8
1989,1231,1431,02,07,-5
1989,1276,1375,03,11,-8
1989,1281,1400,03,11,-8
1989,1301,1234,05,04,1
1989,1314,1417,02,07,-5
1989,1371,1191,03,11,-8
1989,1393,1161,02,10,-8
1989,1276,1314,03,02,1
1989,1371,1231,03,02,1
1989,1424,1112,04,01,3
1989,1438,1328,05,01,4
1989,1181,1278,02,11,-9
1989,1207,1301,01,05,-4
1989,1228,1257,01,04,-3
1989,1393,1281,02,03,-1
1989,1276,1438,03,05,-2
1989,1371,1424,03,04,-1
1989,1181,1207,02,01,1
1989,1228,1393,01,02,-1
1989,1276,1228,03,01,2
1989,1371,1181,03,02,1
1989,1276,1371,03,03,0
1990,1116,1343,04,13,-9
1990,1123,1333,12,05,7
1990,1143,1231,09,08,1
1990,1155,1140,05,12,-7
1990,1163,1131,01,16,-15
1990,1173,1228,12,05,7
1990,1210,1190,04,13,-9
1990,1247,1379,04,13,-9
1990,1257,1225,04,13,-9
1990,1261,1437,05,12,-7
1990,1277,1293,01,16,-15
1990,1314,1283,08,09,-1
1990,1326,1344,08,09,-1
1990,1328,1406,01,16,-15
1990,1364,1222,09,08,1
1990,1424,1114,01,16,-15
1990,1104,1161,07,10,-3
1990,1112,1378,02,15,-13
1990,1181,1350,03,14,-11
1990,1207,1411,03,14,-11
1990,1242,1352,02,15,-13
1990,1258,1308,11,06,5
1990,1276,1229,03,14,-11
1990,1278,1431,06,11,-5
1990,1320,1281,14,03,11
1990,1345,1419,02,15,-13
1990,1385,1396,06,11,-5
1990,1393,1164,02,15,-13
1990,1400,1208,10,07,3
1990,1417,1412,07,10,-3
1990,1438,1323,07,10,-3
1990,1462,1243,06,11,-5
1990,1116,1173,04,12,-8
1990,1123,1257,12,04,8
1990,1155,1247,05,04,1
1990,1163,1143,01,09,-8
1990,1210,1261,04,05,-1
1990,1277,1364,01,09,-8
1990,1314,1328,08,01,7
1990,1424,1326,01,08,-7
1990,1104,1112,07,02,5
1990,1181,1385,03,06,-3
1990,1258,1276,11,03,8
1990,1278,1320,06,14,-8
1990,1393,1438,02,07,-5
1990,1400,1345,10,02,8
1990,1417,1242,07,02,5
1990,1462,1207,06,03,3
1990,1116,1314,04,08,-4
1990,1163,1155,01,05,-4
1990,1181,1417,03,07,-4
1990,1400,1462,10,06,4
1990,1210,1277,04,01,3
1990,1258,1104,11,07,4
1990,1278,1393,06,02,4
1990,1424,1123,01,12,-11
1990,1116,1400,04,10,-6
1990,1181,1163,03,01,2
1990,1210,1278,04,06,-2
1990,1424,1258,01,11,-10
1990,1181,1116,03,04,-1
1990,1424,1210,01,04,-3
1990,1424,1181,01,03,-2
1991,1112,1384,02,15,-13
1991,1140,1438,10,07,3
1991,1163,1261,11,06,5
1991,1166,1308,11,06,5
1991,1181,1419,02,15,-13
1991,1199,1425,07,10,-3
1991,1231,1157,02,15,-13
1991,1234,1190,07,10,-3
1991,1242,1309,03,14,-11
1991,1301,1379,06,11,-5
1991,1329,1307,03,14,-11
1991,1338,1208,06,11,-5
1991,1350,1393,15,02,13
1991,1371,1337,03,14,-11
1991,1396,1345,10,07,3
1991,1462,1304,14,03,11
1991,1104,1293,04,13,-9
1991,1113,1353,08,09,-1
1991,1116,1209,01,16,-15
1991,1185,1280,12,05,7
1991,1207,1435,08,09,-1
1991,1210,1177,08,09,-1
1991,1277,1453,05,12,-7
1991,1314,1318,01,16,-15
1991,1326,1406,01,16,-15
1991,1336,1417,13,04,9
1991,1385,1296,04,13,-9
1991,1400,1389,05,12,-7
1991,1424,1285,01,16,-15
1991,1428,1375,04,13,-9
1991,1437,1343,09,08,1
1991,1448,1256,05,12,-7
1991,1112,1140,02,10,-8
1991,1163,1462,11,14,-3
1991,1181,1234,02,07,-5
1991,1231,1199,02,07,-5
1991,1242,1338,03,06,-3
1991,1329,1301,03,06,-3
1991,1371,1166,03,11,-8
1991,1396,1350,10,15,-5
1991,1104,1448,04,05,-1
1991,1116,1113,01,08,-7
1991,1185,1336,12,13,-1
1991,1314,1437,01,09,-8
1991,1326,1210,01,08,-7
1991,1385,1400,04,05,-1
1991,1424,1207,01,08,-7
1991,1428,1277,04,05,-1
1991,1116,1104,01,04,-3
1991,1242,1231,03,02,1
1991,1371,1112,03,02,1
1991,1424,1428,01,04,-3
1991,1181,1163,02,11,-9
1991,1314,1185,01,12,-11
1991,1385,1326,04,01,3
1991,1396,1329,10,03,7
1991,1242,1116,03,01,2
1991,1424,1371,01,03,-2
1991,1181,1385,02,04,-2
1991,1314,1396,01,10,-9
1991,1181,1424,02,01,1
1991,1242,1314,03,01,2
1991,1181,1242,02,03,-1
1992,1104,1390,05,12,-7
1992,1116,1293,03,14,-11
1992,1163,1304,09,08,1
1992,1181,1144,01,16,-15
1992,1199,1285,03,14,-11
1992,1207,1378,06,11,-5
1992,1210,1222,07,10,-3
1992,1231,1183,02,15,-13
1992,1234,1400,09,08,1
1992,1261,1140,07,10,-3
1992,1272,1337,06,11,-5
1992,1281,1452,05,12,-7
1992,1314,1275,04,13,-9
1992,1326,1290,01,16,-15
1992,1371,1247,04,13,-9
1992,1425,1419,02,15,-13
1992,1153,1174,04,13,-9
1992,1190,1112,14,03,11
1992,1235,1150,10,07,3
1992,1242,1224,01,16,-15
1992,1246,1330,02,15,-13
1992,1257,1448,08,09,-1
1992,1269,1200,03,14,-11
1992,1276,1396,06,11,-5
1992,1277,1283,05,12,-7
1992,1308,1177,12,05,7
1992,1329,1204,02,15,-13
1992,1393,1343,06,11,-5
1992,1408,1385,10,07,3
1992,1417,1352,01,16,-15
1992,1418,1328,13,04,9
1992,1431,1191,09,08,1
1992,1181,1234,01,09,-8
1992,1199,1207,03,06,-3
1992,1210,1425,07,02,5
1992,1231,1261,02,07,-5
1992,1272,1116,06,03,3
1992,1314,1104,04,05,-1
1992,1326,1163,01,09,-8
1992,1371,1281,04,05,-1
1992,1153,1277,04,05,-1
1992,1246,1235,02,10,-8
1992,1269,1393,03,06,-3
1992,1276,1190,06,14,-8
1992,1308,1418,12,13,-1
1992,1329,1408,02,10,-8
1992,1417,1257,01,08,-7
1992,1431,1242,09,01,8
1992,1181,1371,01,04,-3
1992,1231,1199,02,03,-1
1992,1246,1269,02,03,-1
1992,1417,1308,01,12,-11
1992,1153,1431,04,09,-5
1992,1272,1210,06,07,-1
1992,1276,1329,06,02,4
1992,1326,1314,01,04,-3
1992,1181,1246,01,02,-1
1992,1231,1417,02,01,1
1992,1153,1272,04,06,-2
1992,1276,1326,06,01,5
1992,1181,1231,01,02,-1
1992,1276,1153,06,04,2
1992,1181,1276,01,06,-5
1993,1116,1221,04,13,-9
1993,1140,1374,07,10,-3
1993,1143,1261,06,11,-5
1993,1181,1356,03,14,-11
1993,1199,1191,03,14,-11
1993,1228,1253,06,11,-5
1993,1242,1123,02,15,-13
1993,1314,1187,01,16,-15
1993,1348,1345,08,09,-1
1993,1365,1112,15,02,13
1993,1371,1398,02,15,-13
1993,1385,1403,05,12,-7
1993,1396,1281,07,10,-3
1993,1408,1243,11,06,5
1993,1435,1129,03,14,-11
1993,1443,1272,07,10,-3
1993,1153,1164,02,15,-13
1993,1203,1307,12,05,7
1993,1231,1460,01,16,-15
1993,1234,1419,04,13,-9
1993,1246,1351,01,16,-15
1993,1257,1174,04,13,-9
1993,1269,1335,03,14,-11
1993,1276,1157,01,16,-15
1993,1308,1304,07,10,-3
1993,1329,1266,05,12,-7
1993,1380,1210,13,04,9
1993,1417,1235,09,08,1
1993,1428,1338,08,09,-1
1993,1438,1264,06,11,-5
1993,1448,1151,05,12,-7
1993,1462,1309,09,08,1
1993,1116,1385,04,05,-1
1993,1143,1181,06,03,3
1993,1199,1408,03,11,-8
1993,1242,1140,02,07,-5
1993,1314,1348,01,08,-7
1993,1396,1365,07,15,-8
1993,1435,1228,03,06,-3
1993,1443,1371,07,02,5
1993,1153,1308,02,07,-5
1993,1203,1380,12,13,-1
1993,1231,1462,01,09,-8
1993,1246,1428,01,08,-7
1993,1257,1329,04,05,-1
1993,1276,1417,01,09,-8
1993,1438,1269,06,03,3
1993,1448,1234,05,04,1
1993,1199,1443,03,07,-4
1993,1231,1257,01,04,-3
1993,1242,1143,02,06,-4
1993,1246,1448,01,05,-4
1993,1153,1438,02,06,-4
1993,1276,1203,01,12,-11
1993,1314,1116,01,04,-3
1993,1396,1435,07,03,4
1993,1242,1231,02,01,1
1993,1246,1199,01,03,-2
1993,1276,1396,01,07,-6
1993,1314,1153,01,02,-1
1993,1276,1246,01,01,0
1993,1314,1242,01,02,-1
1993,1314,1276,01,01,0
1994,1104,1344,09,08,1
1994,1163,1351,02,15,-13
1994,1196,1241,03,14,-11
1994,1203,1412,10,07,3
1994,1242,1151,04,13,-9
1994,1268,1387,10,07,3
1994,1269,1402,02,15,-13
1994,1276,1337,03,14,-11
1994,1281,1298,01,16,-15
1994,1335,1304,11,06,5
1994,1345,1416,01,16,-15
1994,1393,1218,04,13,-9
1994,1400,1443,06,11,-5
1994,1448,1158,05,12,-7
1994,1453,1143,12,05,7
1994,1458,1153,09,08,1
1994,1112,1259,02,15,-13
1994,1116,1299,01,16,-15
1994,1130,1450,09,08,1
1994,1181,1411,02,15,-13
1994,1207,1228,09,08,1
1994,1231,1325,05,12,-7
1994,1246,1398,03,14,-11
1994,1257,1129,03,14,-11
1994,1266,1418,06,11,-5
1994,1277,1371,07,10,-3
1994,1278,1356,06,11,-5
1994,1314,1251,01,16,-15
1994,1329,1308,04,13,-9
1994,1396,1180,04,13,-9
1994,1409,1417,12,05,7
1994,1438,1307,07,10,-3
1994,1163,1203,02,10,-8
1994,1196,1335,03,11,-8
1994,1242,1448,04,05,-1
1994,1268,1269,10,02,8
1994,1276,1400,03,06,-3
1994,1281,1458,01,09,-8
1994,1345,1104,01,09,-8
1994,1393,1453,04,12,-8
1994,1112,1438,02,07,-5
1994,1116,1207,01,09,-8
1994,1130,1314,09,01,8
1994,1181,1277,02,07,-5
1994,1231,1396,05,04,1
1994,1257,1278,03,06,-3
1994,1266,1246,06,03,3
1994,1409,1329,12,04,8
1994,1112,1257,02,03,-1
1994,1181,1266,02,06,-4
1994,1281,1393,01,04,-3
1994,1345,1242,01,04,-3
1994,1116,1409,01,12,-11
1994,1130,1231,09,05,4
1994,1196,1163,03,02,1
1994,1276,1268,03,10,-7
1994,1112,1281,02,01,1
1994,1181,1345,02,01,1
1994,1116,1276,01,03,-2
1994,1196,1130,03,09,-6
1994,1116,1112,01,02,-1
1994,1181,1196,02,03,-1
1994,1116,1181,01,02,-1
1995,1104,1335,05,12,-7
1995,1113,1123,05,12,-7
1995,1153,1396,07,10,-3
1995,1163,1151,02,15,-13
1995,1242,1159,01,16,-15
1995,1246,1291,01,16,-15
1995,1264,1328,13,04,9
1995,1268,1211,03,14,-11
1995,1275,1112,12,05,7
1995,1329,1180,04,13,-9
1995,1387,1278,09,08,1
1995,1400,1332,11,06,5
1995,1408,1140,09,08,1
1995,1438,1311,04,13,-9
1995,1443,1276,08,09,-1
1995,1448,1299,01,16,-15
1995,1116,1411,02,15,-13
1995,1207,1462,06,11,-5
1995,1235,1196,07,10,-3
1995,1269,1389,02,15,-13
1995,1272,1257,06,11,-5
1995,1280,1365,05,12,-7
1995,1281,1231,08,09,-1
1995,1314,1293,02,15,-13
1995,1330,1437,14,03,11
1995,1345,1453,03,14,-11
1995,1390,1150,10,07,3
1995,1393,1356,07,10,-3
1995,1409,1228,06,11,-5
1995,1417,1198,01,16,-15
1995,1428,1253,04,13,-9
1995,1451,1277,14,03,11
1995,1113,1264,05,13,-8
1995,1163,1153,02,07,-5
1995,1242,1443,01,08,-7
1995,1246,1408,01,09,-8
1995,1268,1400,03,11,-8
1995,1329,1104,04,05,-1
1995,1438,1275,04,12,-8
1995,1448,1387,01,09,-8
1995,1116,1393,02,07,-5
1995,1207,1451,06,14,-8
1995,1269,1390,02,10,-8
1995,1272,1345,06,03,3
1995,1280,1428,05,04,1
1995,1314,1235,02,07,-5
1995,1409,1330,06,14,-8
1995,1417,1281,01,08,-7
1995,1163,1268,02,03,-1
1995,1246,1113,01,05,-4
1995,1314,1207,02,06,-4
1995,1417,1280,01,05,-4
1995,1116,1272,02,06,-4
1995,1269,1409,02,06,-4
1995,1329,1448,04,01,3
1995,1438,1242,04,01,3
1995,1314,1246,02,01,1
1995,1417,1163,01,02,-1
1995,1116,1438,02,04,-2
1995,1329,1269,04,02,2
1995,1116,1314,02,02,0
1995,1417,1329,01,04,-3
1995,1417,1116,01,02,-1
1996,1116,1336,12,05,7
1996,1163,1159,01,16,-15
1996,1180,1272,12,05,7
1996,1185,1181,09,08,1
1996,1208,1155,08,09,-1
1996,1235,1143,05,12,-7
1996,1246,1363,01,16,-15
1996,1266,1284,04,13,-9
1996,1269,1416,01,16,-15
1996,1280,1433,05,12,-7
1996,1343,1417,13,04,9
1996,1345,1441,01,16,-15
1996,1390,1133,09,08,1
1996,1393,1286,04,13,-9
1996,1428,1145,04,13,-9
1996,1439,1453,09,08,1
1996,1112,1434,03,14,-11
1996,1130,1231,11,06,5
1996,1153,1422,02,15,-13
1996,1207,1290,02,15,-13
1996,1210,1122,03,14,-11
1996,1234,1203,06,11,-5
1996,1242,1354,02,15,-13
1996,1257,1409,06,11,-5
1996,1307,1243,07,10,-3
1996,1314,1309,06,11,-5
1996,1365,1268,10,07,3
1996,1396,1328,07,10,-3
1996,1400,1276,10,07,3
1996,1403,1296,03,14,-11
1996,1437,1339,03,14,-11
1996,1448,1419,02,15,-13
1996,1116,1266,12,04,8
1996,1163,1185,01,09,-8
1996,1208,1345,08,01,7
1996,1246,1439,01,09,-8
1996,1269,1390,01,09,-8
1996,1280,1343,05,13,-8
1996,1393,1180,04,12,-8
1996,1428,1235,04,05,-1
1996,1112,1234,03,06,-3
1996,1153,1396,02,07,-5
1996,1207,1307,02,07,-5
1996,1210,1130,03,11,-8
1996,1242,1365,02,10,-8
1996,1257,1437,06,03,3
1996,1403,1314,03,06,-3
1996,1448,1400,02,10,-8
1996,1207,1403,02,03,-1
1996,1246,1428,01,04,-3
1996,1269,1116,01,12,-11
1996,1448,1257,02,06,-4
1996,1153,1210,02,03,-1
1996,1242,1112,02,03,-1
1996,1280,1163,05,01,4
1996,1393,1208,04,08,-4
1996,1246,1448,01,02,-1
1996,1269,1207,01,02,-1
1996,1280,1153,05,02,3
1996,1393,1242,04,02,2
1996,1246,1269,01,01,0
1996,1393,1280,04,05,-1
1996,1246,1393,01,04,-3
1997,1112,1375,04,13,-9
1997,1130,1434,05,12,-7
1997,1143,1343,05,12,-7
1997,1153,1139,03,14,-11
1997,1158,1268,12,05,7
1997,1160,1231,09,08,1
1997,1234,1438,08,09,-1
1997,1235,1229,06,11,-5
1997,1242,1238,01,16,-15
1997,1246,1285,01,16,-15
1997,1314,1193,01,16,-15
1997,1345,1348,08,09,-1
1997,1386,1334,04,13,-9
1997,1417,1149,02,15,-13
1997,1437,1254,04,13,-9
1997,1462,1435,07,10,-3
1997,1150,1207,07,10,-3
1997,1151,1208,14,03,11
1997,1155,1275,04,13,-9
1997,1164,1376,15,02,13
1997,1181,1293,02,15,-13
1997,1228,1425,06,11,-5
1997,1257,1269,06,11,-5
1997,1278,1402,01,16,-15
1997,1307,1330,03,14,-11
1997,1344,1266,10,07,3
1997,1390,1328,06,11,-5
1997,1396,1279,09,08,1
1997,1400,1458,10,07,3
1997,1409,1131,05,12,-7
1997,1428,1298,02,15,-13
1997,1448,1388,03,14,-11
1997,1112,1158,04,12,-8
1997,1143,1437,05,04,1
1997,1235,1153,06,03,3
1997,1242,1345,01,08,-7
1997,1246,1234,01,08,-7
1997,1314,1160,01,09,-8
1997,1386,1130,04,05,-1
1997,1417,1462,02,07,-5
1997,1151,1228,14,06,8
1997,1155,1409,04,05,-1
1997,1257,1307,06,03,3
1997,1278,1396,01,09,-8
1997,1344,1181,10,02,8
1997,1390,1448,06,03,3
1997,1400,1164,10,15,-5
1997,1428,1150,02,07,-5
1997,1246,1386,01,04,-3
1997,1278,1155,01,04,-3
1997,1417,1235,02,06,-4
1997,1428,1390,02,06,-4
1997,1112,1242,04,01,3
1997,1257,1400,06,10,-4
1997,1314,1143,01,05,-4
1997,1344,1151,10,14,-4
1997,1246,1428,01,02,-1
1997,1278,1417,01,02,-1
1997,1112,1344,04,10,-6
1997,1314,1257,01,06,-5
1997,1112,1314,04,01,3
1997,1246,1278,01,01,0
1997,1112,1246,04,01,3
1998,1112,1311,01,16,-15
1998,1116,1304,06,11,-5
1998,1150,1227,08,09,-1
1998,1153,1319,02,15,-13
1998,1163,1192,02,15,-13
1998,1228,1375,05,12,-7
1998,1229,1397,09,08,1
1998,1231,1328,07,10,-3
1998,1268,1429,04,13,-9
1998,1277,1185,04,13,-9
1998,1314,1298,01,16,-15
1998,1343,1424,05,12,-7
1998,1350,1376,14,03,11
1998,1428,1362,03,14,-11
1998,1449,1462,11,06,5
1998,1452,1396,10,07,3
1998,1178,1385,10,07,3
1998,1181,1347,01,16,-15
1998,1199,1395,12,05,7
1998,1242,1341,01,16,-15
1998,1246,1354,02,15,-13
1998,1276,1172,03,14,-11
1998,1307,1139,04,13,-9
1998,1329,1203,08,09,-1
1998,1345,1174,02,15,-13
1998,1348,1293,08,09,-1
1998,1387,1269,10,07,3
1998,1390,1158,03,14,-11
1998,1393,1233,05,12,-7
1998,1417,1274,06,11,-5
1998,1434,1279,13,04,9
1998,1444,1155,11,06,5
1998,1112,1229,01,09,-8
1998,1163,1231,02,07,-5
1998,1268,1228,04,05,-1
1998,1277,1343,04,05,-1
1998,1314,1150,01,08,-7
1998,1428,1116,03,06,-3
1998,1449,1350,11,14,-3
1998,1452,1153,10,02,8
1998,1181,1329,01,08,-7
1998,1246,1387,02,10,-8
1998,1345,1178,02,10,-8
1998,1348,1242,08,01,7
1998,1390,1444,03,11,-8
1998,1393,1307,05,04,1
1998,1417,1276,06,03,3
1998,1434,1199,13,12,1
1998,1112,1268,01,04,-3
1998,1163,1449,02,11,-9
1998,1314,1277,01,04,-3
1998,1428,1452,03,10,-7
1998,1181,1393,01,05,-4
1998,1246,1417,02,06,-4
1998,1348,1434,08,13,-5
1998,1390,1345,03,02,1
1998,1314,1163,01,02,-1
1998,1428,1112,03,01,2
1998,1246,1181,02,01,1
1998,1390,1348,03,08,-5
1998,1246,1390,02,03,-1
1998,1428,1314,03,01,2
1998,1246,1428,02,03,-1
1999,1116,1373,04,13,-9
1999,1120,1457,01,16,-15
1999,1163,1427,01,16,-15
1999,1166,1257,10,07,3
1999,1178,1417,12,05,7
1999,1196,1335,06,11,-5
1999,1211,1278,10,07,3
1999,1231,1203,06,11,-5
1999,1234,1412,05,12,-7
1999,1268,1434,02,15,-13
1999,1307,1281,09,08,1
1999,1326,1293,04,13,-9
1999,1329,1393,09,08,1
1999,1385,1359,03,14,-11
1999,1390,1108,02,15,-13
1999,1451,1314,14,03,11
1999,1150,1348,05,12,-7
1999,1153,1206,03,14,-11
1999,1181,1197,01,16,-15
1999,1242,1191,06,11,-5
1999,1246,1308,03,14,-11
1999,1274,1248,02,15,-13
1999,1275,1449,10,07,3
1999,1277,1291,01,16,-15
1999,1279,1437,09,08,1
1999,1283,1458,12,05,7
1999,1328,1112,13,04,9
1999,1345,1400,10,07,3
1999,1396,1245,06,11,-5
1999,1397,1174,04,13,-9
1999,1409,1158,09,08,1
1999,1428,1117,02,15,-13
1999,1120,1329,01,09,-8
1999,1163,1307,01,09,-8
1999,1196,1451,06,14,-8
1999,1211,1390,10,02,8
1999,1234,1116,05,04,1
1999,1268,1166,02,10,-8
1999,1326,1178,04,12,-8
1999,1385,1231,03,06,-3
1999,1181,1409,01,09,-8
1999,1246,1242,03,06,-3
1999,1275,1428,10,02,8
1999,1277,1279,01,09,-8
1999,1283,1397,12,04,8
1999,1328,1150,13,05,8
1999,1345,1274,10,02,8
1999,1396,1153,06,03,3
1999,1163,1234,01,05,-4
1999,1211,1196,10,06,4
1999,1326,1120,04,01,3
1999,1385,1268,03,02,1
1999,1181,1283,01,12,-11
1999,1246,1275,03,10,-7
1999,1277,1328,01,13,-12
1999,1396,1345,06,10,-4
1999,1163,1211,01,10,-9
1999,1326,1385,04,03,1
1999,1181,1396,01,06,-5
1999,1277,1246,01,03,-2
1999,1163,1326,01,04,-3
1999,1181,1277,01,01,0
1999,1163,1181,01,01,0
2000,1112,1238,01,16,-15
2000,1120,1166,07,10,-3
2000,1211,1257,10,07,3
2000,1235,1148,02,15,-13
2000,1246,1382,05,12,-7
2000,1261,1369,04,13,-9
2000,1268,1233,03,14,-11
2000,1277,1434,01,16,-15
2000,1328,1457,03,14,-11
2000,1345,1173,06,11,-5
2000,1385,1319,02,15,-13
2000,1393,1359,04,13,-9
2000,1400,1232,05,12,-7
2000,1417,1123,06,11,-5
2000,1428,1387,08,09,-1
2000,1458,1201,08,09,-1
2000,1153,1423,02,15,-13
2000,1163,1429,05,12,-7
2000,1181,1249,01,16,-15
2000,1196,1139,05,12,-7
2000,1228,1335,04,13,-9
2000,1242,1177,08,09,-1
2000,1274,1116,06,11,-5
2000,1314,1281,08,09,-1
2000,1326,1111,03,14,-11
2000,1329,1220,03,14,-11
2000,1337,1231,11,06,5
2000,1371,1332,10,07,3
2000,1390,1354,01,16,-15
2000,1396,1248,02,15,-13
2000,1397,1418,04,13,-9
2000,1409,1424,07,10,-3
2000,1211,1385,10,02,8
2000,1235,1120,02,07,-5
2000,1261,1400,04,05,-1
2000,1277,1428,01,08,-7
2000,1345,1328,06,03,3
2000,1393,1246,04,05,-1
2000,1417,1268,06,03,3
2000,1458,1112,08,01,7
2000,1181,1242,01,08,-7
2000,1196,1228,05,04,1
2000,1274,1326,06,03,3
2000,1314,1390,08,01,7
2000,1329,1337,03,11,-8
2000,1371,1396,10,02,8
2000,1397,1163,04,05,-1
2000,1409,1153,07,02,5
2000,1235,1417,02,06,-4
2000,1277,1393,01,04,-3
2000,1345,1211,06,10,-4
2000,1458,1261,08,04,4
2000,1196,1181,05,01,4
2000,1314,1397,08,04,4
2000,1329,1371,03,10,-7
2000,1409,1274,07,06,1
2000,1277,1235,01,02,-1
2000,1458,1345,08,06,2
2000,1196,1329,05,03,2
2000,1314,1409,08,07,1
2000,1196,1314,05,08,-3
2000,1277,1458,01,08,-7
2000,1277,1196,01,05,-4
2001,1322,1457,16,16,0
2001,1130,1381,03,14,-11
2001,1153,1140,05,12,-7
2001,1181,1284,01,16,-15
2001,1207,1116,10,07,3
2001,1209,1458,11,06,5
2001,1214,1235,15,02,13
2001,1234,1166,07,10,-3
2001,1245,1231,13,04,9
2001,1246,1221,02,15,-13
2001,1268,1206,03,14,-11
2001,1281,1208,09,08,1
2001,1386,1210,09,08,1
2001,1390,1422,01,16,-15
2001,1417,1220,04,13,-9
2001,1425,1329,06,11,-5
2001,1429,1326,12,05,7
2001,1112,1183,02,15,-13
2001,1139,1448,10,07,3
2001,1150,1397,09,08,1
2001,1196,1443,03,14,-11
2001,1201,1143,09,08,1
2001,1211,1438,12,05,7
2001,1228,1322,01,16,-15
2001,1232,1328,13,04,9
2001,1242,1169,04,13,-9
2001,1277,1106,01,16,-15
2001,1279,1233,03,14,-11
2001,1314,1343,02,15,-13
2001,1323,1462,06,11,-5
2001,1336,1344,07,10,-3
2001,1393,1218,05,12,-7
2001,1396,1400,11,06,5
2001,1153,1245,05,13,-8
2001,1181,1281,01,09,-8
2001,1207,1214,10,15,-5
2001,1246,1234,02,07,-5
2001,1268,1209,03,11,-8
2001,1390,1386,01,09,-8
2001,1417,1429,04,12,-8
2001,1425,1130,06,03,3
2001,1112,1139,02,10,-8
2001,1211,1232,12,13,-1
2001,1228,1150,01,09,-8
2001,1242,1393,04,05,-1
2001,1277,1201,01,09,-8
2001,1279,1323,03,06,-3
2001,1336,1314,07,02,5
2001,1396,1196,11,03,8
2001,1181,1417,01,04,-3
2001,1268,1207,03,10,-7
2001,1390,1153,01,05,-4
2001,1425,1246,06,02,4
2001,1112,1279,02,03,-1
2001,1228,1242,01,04,-3
2001,1277,1211,01,12,-11
2001,1396,1336,11,07,4
2001,1181,1425,01,06,-5
2001,1268,1390,03,01,2
2001,1112,1228,02,01,1
2001,1277,1396,01,11,-10
2001,1112,1277,02,01,1
2001,1181,1268,01,03,-2
2001,1181,1112,01,02,-1
2002,1373,1108,16,16,0
2002,1104,1194,02,15,-13
2002,1112,1364,03,14,-11
2002,1181,1457,01,16,-15
2002,1231,1428,05,12,-7
2002,1242,1221,01,16,-15
2002,1245,1329,10,07,3
2002,1246,1434,04,13,-9
2002,1281,1274,12,05,7
2002,1323,1150,08,09,-1
2002,1326,1172,04,13,-9
2002,1332,1285,02,15,-13
2002,1390,1443,08,09,-1
2002,1409,1266,12,05,7
2002,1423,1425,13,04,9
2002,1448,1337,07,10,-3
2002,1461,1211,11,06,5
2002,1143,1335,06,11,-5
2002,1153,1131,01,16,-15
2002,1163,1214,02,15,-13
2002,1166,1196,12,05,7
2002,1208,1293,03,14,-11
2002,1228,1361,04,13,-9
2002,1268,1373,01,16,-15
2002,1280,1270,03,14,-11
2002,1301,1277,07,10,-3
2002,1328,1227,02,15,-13
2002,1338,1148,03,14,-11
2002,1356,1403,11,06,5
2002,1400,1130,06,11,-5
2002,1417,1279,08,09,-1
2002,1458,1385,08,09,-1
2002,1462,1218,07,10,-3
2002,1112,1461,03,11,-8
2002,1181,1323,01,08,-7
2002,1231,1423,05,13,-8
2002,1242,1390,01,08,-7
2002,1245,1104,10,02,8
2002,1246,1409,04,12,-8
2002,1281,1326,12,04,8
2002,1332,1448,02,07,-5
2002,1163,1301,02,07,-5
2002,1228,1166,04,12,-8
2002,1268,1458,01,08,-7
2002,1328,1462,02,07,-5
2002,1338,1143,03,06,-3
2002,1356,1208,11,03,8
2002,1400,1280,06,03,3
2002,1417,1153,08,01,7
2002,1231,1181,05,01,4
2002,1245,1338,10,03,7
2002,1281,1417,12,08,4
2002,1328,1112,02,03,-1
2002,1163,1356,02,11,-9
2002,1242,1228,01,04,-3
2002,1268,1246,01,04,-3
2002,1332,1400,02,06,-4
2002,1231,1245,05,10,-5
2002,1328,1281,02,12,-10
2002,1242,1332,01,02,-1
2002,1268,1163,01,02,-1
2002,1231,1328,05,02,3
2002,1268,1242,01,01,0
2002,1268,1231,01,05,-4
2003,1421,1411,16,16,0
2003,1112,1436,01,16,-15
2003,1113,1272,10,07,3
2003,1141,1166,11,06,5
2003,1143,1301,08,09,-1
2003,1163,1140,05,12,-7
2003,1181,1161,03,14,-11
2003,1211,1153,09,08,1
2003,1228,1443,04,13,-9
2003,1242,1429,02,15,-13
2003,1266,1221,03,14,-11
2003,1281,1356,06,11,-5
2003,1323,1454,05,12,-7
2003,1328,1354,01,16,-15
2003,1390,1360,04,13,-9
2003,1409,1173,13,04,9
2003,1458,1451,05,12,-7
2003,1120,1386,10,07,3
2003,1139,1280,12,05,7
2003,1196,1358,02,15,-13
2003,1231,1104,07,10,-3
2003,1246,1237,01,16,-15
2003,1257,1122,04,13,-9
2003,1268,1423,06,11,-5
2003,1277,1160,07,10,-3
2003,1329,1335,06,11,-5
2003,1338,1447,02,15,-13
2003,1345,1261,09,08,1
2003,1393,1264,03,14,-11
2003,1400,1421,01,16,-15
2003,1428,1332,09,08,1
2003,1448,1190,02,15,-13
2003,1462,1407,03,14,-11
2003,1112,1211,01,09,-8
2003,1163,1390,05,04,1
2003,1181,1141,03,11,-8
2003,1242,1113,02,10,-8
2003,1266,1281,03,06,-3
2003,1323,1228,05,04,1
2003,1328,1143,01,08,-7
2003,1458,1409,05,13,-8
2003,1120,1448,10,02,8
2003,1139,1257,12,04,8
2003,1246,1428,01,09,-8
2003,1268,1462,06,03,3
2003,1277,1196,07,02,5
2003,1338,1231,02,07,-5
2003,1393,1329,03,06,-3
2003,1400,1345,01,09,-8
2003,1112,1323,01,05,-4
2003,1242,1181,02,03,-1
2003,1246,1458,01,05,-4
2003,1266,1338,03,02,1
2003,1277,1268,07,06,1
2003,1328,1139,01,12,-11
2003,1393,1120,03,10,-7
2003,1400,1163,01,05,-4
2003,1242,1112,02,01,1
2003,1266,1246,03,01,2
2003,1393,1328,03,01,2
2003,1400,1277,01,07,-6
2003,1242,1266,02,03,-1
2003,1393,1400,03,01,2
2003,1393,1242,03,02,1
2004,1197,1250,16,16,0
2004,1104,1356,08,09,-1
2004,1163,1436,02,15,-13
2004,1177,1173,07,10,-3
2004,1181,1106,01,16,-15
2004,1211,1434,02,15,-13
2004,1264,1196,12,05,7
2004,1268,1431,04,13,-9
2004,1305,1277,10,07,3
2004,1314,1102,06,11,-5
2004,1371,1112,08,09,-1
2004,1386,1251,01,16,-15
2004,1390,1427,01,16,-15
2004,1393,1140,05,12,-7
2004,1400,1343,03,14,-11
2004,1403,1150,08,09,-1
2004,1448,1433,04,13,-9
2004,1130,1428,06,11,-5
2004,1153,1190,04,13,-9
2004,1210,1320,03,14,-11
2004,1228,1293,05,12,-7
2004,1242,1227,04,13,-9
2004,1246,1197,01,16,-15
2004,1272,1376,07,10,-3
2004,1280,1284,02,15,-13
2004,1301,1418,03,14,-11
2004,1329,1186,02,15,-13
2004,1334,1344,12,05,7
2004,1338,1416,03,14,-11
2004,1412,1449,09,08,1
2004,1435,1444,06,11,-5
2004,1458,1350,06,11,-5
2004,1462,1257,07,10,-3
2004,1104,1390,08,01,7
2004,1163,1177,02,07,-5
2004,1181,1371,01,08,-7
2004,1305,1211,10,02,8
2004,1386,1403,01,08,-7
2004,1393,1268,05,04,1
2004,1400,1314,03,06,-3
2004,1448,1264,04,12,-8
2004,1210,1130,03,06,-3
2004,1228,1153,05,04,1
2004,1242,1334,04,12,-8
2004,1329,1272,02,07,-5
2004,1338,1458,03,06,-3
2004,1412,1246,09,01,8
2004,1435,1301,06,03,3
2004,1462,1280,07,02,5
2004,1104,1393,08,05,3
2004,1163,1435,02,06,-4
2004,1329,1338,02,03,-1
2004,1386,1448,01,04,-3
2004,1181,1228,01,05,-4
2004,1210,1305,03,10,-7
2004,1242,1412,04,09,-5
2004,1462,1400,07,03,4
2004,1163,1104,02,08,-6
2004,1329,1386,02,01,1
2004,1181,1462,01,07,-6
2004,1210,1242,03,04,-1
2004,1163,1181,02,01,1
2004,1210,1329,03,02,1
2004,1163,1210,02,03,-1
2005,1324,1105,16,16,0
2005,1112,1429,03,14,-11
2005,1130,1335,04,13,-9
2005,1153,1234,07,10,-3
2005,1211,1457,03,14,-11
2005,1228,1192,01,16,-15
2005,1246,1184,02,15,-13
2005,1305,1400,09,08,1
2005,1328,1310,03,14,-11
2005,1334,1338,08,09,-1
2005,1403,1417,06,11,-5
2005,1412,1261,11,06,5
2005,1428,1431,06,11,-5
2005,1448,1151,02,15,-13
2005,1449,1285,01,16,-15
2005,1452,1166,07,10,-3
2005,1454,1104,12,05,7
2005,1137,1242,14,03,11
2005,1163,1416,02,15,-13
2005,1181,1175,01,16,-15
2005,1196,1325,04,13,-9
2005,1210,1203,05,12,-7
2005,1235,1278,09,08,1
2005,1257,1418,04,13,-9
2005,1277,1330,05,12,-7
2005,1280,1390,09,08,1
2005,1301,1150,10,07,3
2005,1314,1324,01,16,-15
2005,1329,1368,02,15,-13
2005,1356,1388,07,10,-3
2005,1436,1393,13,04,9
2005,1437,1307,05,12,-7
2005,1458,1320,06,11,-5
2005,1112,1412,03,11,-8
2005,1228,1305,01,09,-8
2005,1246,1153,02,07,-5
2005,1403,1211,06,03,3
2005,1428,1328,06,03,3
2005,1449,1334,01,08,-7
2005,1452,1448,07,02,5
2005,1454,1130,12,04,8
2005,1181,1280,01,09,-8
2005,1257,1210,04,05,-1
2005,1277,1436,05,13,-8
2005,1301,1163,10,02,8
2005,1314,1235,01,09,-8
2005,1329,1356,02,07,-5
2005,1437,1196,05,04,1
2005,1458,1137,06,14,-8
2005,1112,1329,03,02,1
2005,1228,1454,01,12,-11
2005,1257,1449,04,01,3
2005,1452,1403,07,06,1
2005,1246,1428,02,06,-4
2005,1277,1181,05,01,4
2005,1314,1437,01,05,-4
2005,1458,1301,06,10,-4
2005,1228,1112,01,03,-2
2005,1257,1452,04,07,-3
2005,1277,1246,05,02,3
2005,1314,1458,01,06,-5
2005,1228,1257,01,04,-3
2005,1314,1277,01,05,-4
2005,1314,1228,01,01,0
2006,1284,1214,16,16,0
2006,1104,1266,10,07,3
2006,1130,1334,04,13,-9
2006,1181,1380,01,16,-15
2006,1196,1375,03,14,-11
2006,1203,1423,08,09,-1
2006,1211,1462,03,14,-11
2006,1228,1102,04,13,-9
2006,1231,1361,06,11,-5
2006,1261,1233,04,13,-9
2006,1285,1305,12,05,7
2006,1397,1457,02,15,-13
2006,1401,1393,12,05,7
2006,1417,1125,02,15,-13
2006,1449,1429,05,12,-7
2006,1454,1328,11,06,5
2006,1455,1371,07,10,-3
2006,1112,1458,08,09,-1
2006,1133,1242,13,04,9
2006,1137,1116,09,08,1
2006,1163,1107,01,16,-15
2006,1206,1277,11,06,5
2006,1207,1320,07,10,-3
2006,1246,1412,08,09,-1
2006,1272,1331,01,16,-15
2006,1301,1143,10,07,3
2006,1314,1293,03,14,-11
2006,1322,1234,14,03,11
2006,1326,1172,02,15,-13
2006,1338,1245,05,12,-7
2006,1400,1335,02,15,-13
2006,1437,1284,01,16,-15
2006,1452,1356,06,11,-5
2006,1130,1285,04,12,-8
2006,1181,1203,01,08,-7
2006,1196,1454,03,11,-8
2006,1211,1231,03,06,-3
2006,1261,1401,04,12,-8
2006,1417,1104,02,10,-8
2006,1449,1228,05,04,1
2006,1455,1397,07,02,5
2006,1133,1338,13,05,8
2006,1163,1246,01,08,-7
2006,1206,1314,11,03,8
2006,1207,1326,07,02,5
2006,1272,1137,01,09,-8
2006,1400,1301,02,10,-8
2006,1437,1112,01,08,-7
2006,1452,1322,06,14,-8
2006,1261,1181,04,01,3
2006,1272,1133,01,13,-12
2006,1400,1452,02,06,-4
2006,1417,1211,02,03,-1
2006,1163,1449,01,05,-4
2006,1196,1207,03,07,-4
2006,1206,1455,11,07,4
2006,1437,1130,01,04,-3
2006,1261,1400,04,02,2
2006,1417,1272,02,01,1
2006,1196,1437,03,01,2
2006,1206,1163,11,01,10
2006,1196,1206,03,11,-8
2006,1417,1261,02,04,-2
2006,1196,1417,03,02,1
2007,1310,1197,16,16,0
2007,1130,1403,07,10,-3
2007,1139,1330,05,12,-7
2007,1207,1125,02,15,-13
2007,1231,1211,07,10,-3
2007,1257,1390,06,11,-5
2007,1268,1172,04,13,-9
2007,1277,1266,09,08,1
2007,1314,1184,01,16,-15
2007,1326,1148,01,16,-15
2007,1338,1460,03,14,-11
2007,1401,1335,03,14,-11
2007,1417,1451,02,15,-13
2007,1433,1181,11,06,5
2007,1435,1203,06,11,-5
2007,1450,1331,03,14,-11
2007,1462,1140,09,08,1
2007,1196,1238,01,16,-15
2007,1242,1310,01,16,-15
2007,1246,1437,08,09,-1
2007,1272,1317,02,15,-13
2007,1305,1166,07,10,-3
2007,1332,1275,03,14,-11
2007,1345,1112,09,08,1
2007,1356,1221,04,13,-9
2007,1397,1253,05,12,-7
2007,1400,1308,04,13,-9
2007,1424,1210,07,10,-3
2007,1425,1116,05,12,-7
2007,1438,1107,04,13,-9
2007,1439,1228,05,12,-7
2007,1457,1323,11,06,5
2007,1458,1394,02,15,-13
2007,1139,1268,05,04,1
2007,1207,1130,02,07,-5
2007,1314,1277,01,09,-8
2007,1326,1462,01,09,-8
2007,1338,1433,03,11,-8
2007,1401,1257,03,06,-3
2007,1417,1231,02,07,-5
2007,1435,1450,06,03,3
2007,1196,1345,01,09,-8
2007,1242,1246,01,08,-7
2007,1272,1305,02,07,-5
2007,1332,1457,03,11,-8
2007,1356,1439,04,05,-1
2007,1397,1438,05,04,1
2007,1424,1458,07,02,5
2007,1425,1400,05,04,1
2007,1242,1356,01,04,-3
2007,1272,1401,02,03,-1
2007,1326,1397,01,05,-4
2007,1417,1338,02,03,-1
2007,1196,1139,01,05,-4
2007,1207,1435,02,06,-4
2007,1314,1425,01,05,-4
2007,1332,1424,03,07,-4
2007,1326,1272,01,02,-1
2007,1417,1242,02,01,1
2007,1196,1332,01,03,-2
2007,1207,1314,02,01,1
2007,1196,1417,01,02,-1
2007,1326,1207,01,02,-1
2007,1196,1326,01,01,0
2008,1291,1164,16,16,0
2008,1181,1125,02,15,-13
2008,1242,1340,01,16,-15
2008,1243,1425,11,06,5
2008,1266,1246,06,11,-5
2008,1277,1396,05,12,-7
2008,1323,1206,05,12,-7
2008,1338,1331,04,13,-9
2008,1345,1124,06,11,-5
2008,1390,1165,03,14,-11
2008,1401,1140,09,08,1
2008,1417,1290,01,16,-15
2008,1424,1245,08,09,-1
2008,1450,1457,04,13,-9
2008,1452,1112,07,10,-3
2008,1458,1168,03,14,-11
2008,1462,1208,03,14,-11
2008,1116,1231,09,08,1
2008,1139,1375,07,10,-3
2008,1172,1211,10,07,3
2008,1207,1420,02,15,-13
2008,1257,1129,03,14,-11
2008,1272,1426,01,16,-15
2008,1274,1388,07,10,-3
2008,1280,1332,08,09,-1
2008,1314,1291,01,16,-15
2008,1328,1386,06,11,-5
2008,1360,1163,13,04,9
2008,1373,1435,13,04,9
2008,1397,1110,02,15,-13
2008,1400,1122,02,15,-13
2008,1437,1155,12,05,7
2008,1443,1179,12,05,7
2008,1242,1424,01,08,-7
2008,1277,1338,05,04,1
2008,1390,1266,03,06,-3
2008,1417,1401,01,09,-8
2008,1450,1323,04,05,-1
2008,1452,1181,07,02,5
2008,1458,1243,03,11,-8
2008,1462,1345,03,06,-3
2008,1172,1207,10,02,8
2008,1257,1328,03,06,-3
2008,1272,1280,01,08,-7
2008,1314,1116,01,09,-8
2008,1397,1139,02,07,-5
2008,1400,1274,02,07,-5
2008,1437,1373,12,13,-1
2008,1443,1360,12,13,-1
2008,1257,1397,03,02,1
2008,1314,1450,01,04,-3
2008,1417,1443,01,12,-11
2008,1462,1452,03,07,-4
2008,1172,1458,10,03,7
2008,1242,1437,01,12,-11
2008,1272,1277,01,05,-4
2008,1400,1390,02,03,-1
2008,1314,1257,01,03,-2
2008,1417,1462,01,03,-2
2008,1242,1172,01,10,-9
2008,1272,1400,01,02,-1
2008,1242,1314,01,01,0
2008,1272,1417,01,01,0
2008,1242,1272,01,01,0
2009,1287,1106,16,16,0
2009,1163,1151,01,16,-15
2009,1181,1127,02,15,-13
2009,1211,1103,04,13,-9
2009,1261,1139,08,09,-1
2009,1268,1143,10,07,3
2009,1272,1169,02,15,-13
2009,1276,1155,10,07,3
2009,1314,1347,01,16,-15
2009,1328,1288,02,15,-13
2009,1345,1320,05,12,-7
2009,1400,1278,07,10,-3
2009,1401,1140,09,08,1
2009,1417,1433,06,11,-5
2009,1437,1110,03,14,-11
2009,1443,1228,12,05,7
2009,1449,1280,04,13,-9
2009,1112,1428,12,05,7
2009,1113,1396,06,11,-5
2009,1156,1448,13,04,9
2009,1173,1452,11,06,5
2009,1242,1295,03,14,-11
2009,1257,1287,01,16,-15
2009,1266,1429,06,11,-5
2009,1277,1352,02,15,-13
2009,1281,1165,03,14,-11
2009,1329,1397,08,09,-1
2009,1338,1190,01,16,-15
2009,1373,1326,09,08,1
2009,1393,1372,03,14,-11
2009,1425,1130,10,07,3
2009,1458,1199,12,05,7
2009,1462,1340,04,13,-9
2009,1163,1401,01,09,-8
2009,1181,1400,02,07,-5
2009,1211,1443,04,12,-8
2009,1272,1268,02,10,-8
2009,1314,1261,01,08,-7
2009,1328,1276,02,10,-8
2009,1345,1449,05,04,1
2009,1437,1417,03,06,-3
2009,1112,1156,12,13,-1
2009,1242,1173,03,11,-8
2009,1257,1373,01,09,-8
2009,1277,1425,02,10,-8
2009,1281,1266,03,06,-3
2009,1338,1329,01,08,-7
2009,1393,1113,03,06,-3
2009,1462,1458,04,12,-8
2009,1163,1345,01,05,-4
2009,1281,1272,03,02,1
2009,1338,1462,01,04,-3
2009,1437,1181,03,02,1
2009,1257,1112,01,12,-11
2009,1277,1242,02,03,-1
2009,1314,1211,01,04,-3
2009,1328,1393,02,03,-1
2009,1163,1281,01,03,-2
2009,1437,1338,03,01,2
2009,1277,1257,02,01,1
2009,1314,1328,01,02,-1
2009,1277,1163,02,01,1
2009,1314,1437,01,03,-2
2009,1314,1277,01,02,-1
2010,1115,1457,16,16,0
2010,1124,1358,03,14,-11
2010,1139,1431,05,12,-7
2010,1140,1196,07,10,-3
2010,1242,1250,01,16,-15
2010,1243,1317,02,15,-13
2010,1246,1190,01,16,-15
2010,1293,1435,13,04,9
2010,1307,1285,03,14,-11
2010,1320,1424,09,08,1
2010,1325,1207,14,03,11
2010,1330,1323,11,06,5
2010,1388,1350,10,07,3
2010,1397,1361,06,11,-5
2010,1437,1352,02,15,-13
2010,1448,1400,09,08,1
2010,1449,1266,11,06,5
2010,1143,1257,08,09,-1
2010,1165,1396,12,05,7
2010,1181,1115,01,16,-15
2010,1210,1329,10,07,3
2010,1211,1199,08,09,-1
2010,1268,1222,04,13,-9
2010,1277,1308,05,12,-7
2010,1281,1155,10,07,3
2010,1326,1364,02,15,-13
2010,1338,1324,03,14,-11
2010,1345,1373,04,13,-9
2010,1393,1436,01,16,-15
2010,1401,1429,05,12,-7
2010,1452,1288,02,15,-13
2010,1458,1459,04,13,-9
2010,1462,1278,06,11,-5
2010,1124,1330,03,11,-8
2010,1139,1293,05,13,-8
2010,1243,1140,02,07,-5
2010,1246,1448,01,09,-8
2010,1320,1242,09,01,8
2010,1388,1437,10,02,8
2010,1397,1325,06,14,-8
2010,1449,1307,11,03,8
2010,1165,1458,12,04,8
2010,1181,1143,01,08,-7
2010,1277,1268,05,04,1
2010,1326,1210,02,10,-8
2010,1345,1401,04,05,-1
2010,1393,1211,01,08,-7
2010,1452,1281,02,10,-8
2010,1462,1338,06,03,3
2010,1139,1393,05,01,4
2010,1243,1462,02,06,-4
2010,1246,1165,01,12,-11
2010,1452,1449,02,11,-9
2010,1124,1388,03,10,-7
2010,1181,1345,01,04,-3
2010,1277,1320,05,09,-4
2010,1397,1326,06,02,4
2010,1139,1243,05,02,3
2010,1452,1246,02,01,1
2010,1181,1124,01,03,-2
2010,1277,1397,05,06,-1
2010,1139,1277,05,05,0
2010,1181,1452,01,02,-1
2010,1181,1139,01,05,-4
2011,1155,1412,12,12,0
2011,1421,1114,16,16,0
2011,1427,1106,16,16,0
2011,1433,1425,11,11,0
2011,1139,1330,08,09,-1
2011,1140,1459,03,14,-11
2011,1153,1281,06,11,-5
2011,1163,1137,03,14,-11
2011,1196,1364,02,15,-13
2011,1211,1385,11,06,5
2011,1243,1429,05,12,-7
2011,1246,1343,04,13,-9
2011,1287,1257,13,04,9
2011,1338,1421,01,16,-15
2011,1350,1435,12,05,7
2011,1361,1294,02,15,-13
2011,1396,1336,07,10,-3
2011,1417,1277,07,10,-3
2011,1452,1155,05,12,-7
2011,1458,1125,04,13,-9
2011,1112,1272,05,12,-7
2011,1181,1214,01,16,-15
2011,1199,1401,10,07,3
2011,1206,1437,08,09,-1
2011,1228,1424,09,08,1
2011,1242,1131,01,16,-15
2011,1266,1462,11,06,5
2011,1276,1397,08,09,-1
2011,1314,1254,02,15,-13
2011,1323,1103,02,15,-13
2011,1326,1427,01,16,-15
2011,1345,1389,03,14,-11
2011,1393,1232,03,14,-11
2011,1400,1324,04,13,-9
2011,1433,1207,11,06,5
2011,1449,1208,07,10,-3
2011,1139,1338,08,01,7
2011,1140,1211,03,11,-8
2011,1163,1153,03,06,-3
2011,1196,1417,02,07,-5
2011,1246,1452,04,05,-1
2011,1350,1287,12,13,-1
2011,1361,1396,02,07,-5
2011,1458,1243,04,05,-1
2011,1112,1400,05,04,1
2011,1181,1276,01,08,-7
2011,1199,1323,10,02,8
2011,1242,1228,01,09,-8
2011,1266,1393,11,03,8
2011,1314,1449,02,07,-5
2011,1326,1206,01,08,-7
2011,1433,1345,11,03,8
2011,1112,1181,05,01,4
2011,1139,1458,08,04,4
2011,1163,1361,03,02,1
2011,1196,1140,02,03,-1
2011,1242,1350,01,12,-11
2011,1246,1326,04,01,3
2011,1314,1266,02,11,-9
2011,1433,1199,11,10,1
2011,1139,1196,08,02,6
2011,1163,1112,03,05,-2
2011,1246,1314,04,02,2
2011,1433,1242,11,01,10
2011,1139,1433,08,11,-3
2011,1163,1246,03,04,-1
2011,1163,1139,03,08,-5
2012,1140,1233,14,14,0
2012,1443,1290,16,16,0
2012,1378,1143,12,12,0
2012,1436,1249,16,16,0
2012,1124,1355,03,14,-11
2012,1160,1424,11,06,5
2012,1211,1452,07,10,-3
2012,1231,1308,04,13,-9
2012,1235,1163,08,09,-1
2012,1243,1379,08,09,-1
2012,1246,1443,01,16,-15
2012,1257,1172,04,13,-9
2012,1266,1140,03,14,-11
2012,1293,1161,06,11,-5
2012,1307,1253,05,12,-7
2012,1326,1259,02,15,-13
2012,1393,1421,01,16,-15
2012,1433,1455,12,05,7
2012,1435,1217,05,12,-7
2012,1458,1285,04,13,-9
2012,1153,1400,06,11,-5
2012,1166,1104,08,09,-1
2012,1196,1438,07,10,-3
2012,1199,1382,03,14,-11
2012,1207,1125,03,14,-11
2012,1242,1178,02,15,-13
2012,1250,1181,15,02,13
2012,1277,1254,01,16,-15
2012,1301,1361,11,06,5
2012,1313,1281,15,02,13
2012,1314,1436,01,16,-15
2012,1325,1276,13,04,9
2012,1345,1388,10,07,3
2012,1378,1396,12,05,7
2012,1387,1272,09,08,1
2012,1462,1323,10,07,3
2012,1124,1160,03,11,-8
2012,1231,1433,04,12,-8
2012,1246,1235,01,08,-7
2012,1257,1307,04,05,-1
2012,1266,1293,03,06,-3
2012,1326,1211,02,07,-5
2012,1393,1243,01,08,-7
2012,1458,1435,04,05,-1
2012,1153,1199,06,03,3
2012,1196,1313,07,15,-8
2012,1242,1345,02,10,-8
2012,1277,1387,01,09,-8
2012,1301,1207,11,03,8
2012,1314,1166,01,08,-7
2012,1325,1378,13,12,1
2012,1462,1250,10,15,-5
2012,1196,1266,07,03,4
2012,1257,1277,04,01,3
2012,1326,1153,02,06,-4
2012,1393,1458,01,04,-3
2012,1124,1462,03,10,-7
2012,1242,1301,02,11,-9
2012,1246,1231,01,04,-3
2012,1314,1325,01,13,-12
2012,1257,1196,04,07,-3
2012,1326,1393,02,01,1
2012,1242,1314,02,01,1
2012,1246,1124,01,03,-2
2012,1242,1326,02,02,0
2012,1246,1257,01,04,-3
2012,1246,1242,01,02,-1
2013,1299,1251,16,16,0
2013,1388,1292,11,11,0
2013,1241,1254,16,16,0
2013,1247,1129,13,13,0
2013,1112,1125,06,11,-5
2013,1139,1137,06,11,-5
2013,1143,1424,12,05,7
2013,1161,1281,08,09,-1
2013,1211,1380,01,16,-15
2013,1217,1307,14,03,11
2013,1257,1299,01,16,-15
2013,1266,1172,03,14,-11
2013,1272,1388,06,11,-5
2013,1276,1355,04,13,-9
2013,1277,1434,03,14,-11
2013,1332,1329,12,05,7
2013,1387,1308,04,13,-9
2013,1393,1285,04,13,-9
2013,1433,1103,05,12,-7
2013,1455,1338,09,08,1
2013,1166,1153,07,10,-3
2013,1181,1107,02,15,-13
2013,1195,1207,15,02,13
2013,1196,1322,03,14,-11
2013,1228,1160,07,10,-3
2013,1231,1241,01,16,-15
2013,1235,1323,10,07,3
2013,1242,1443,01,16,-15
2013,1247,1243,13,04,9
2013,1274,1334,02,15,-13
2013,1278,1417,11,06,5
2013,1279,1458,12,05,7
2013,1314,1437,08,09,-1
2013,1326,1233,02,15,-13
2013,1361,1328,07,10,-3
2013,1396,1301,09,08,1
2013,1112,1217,06,14,-8
2013,1257,1161,01,08,-7
2013,1266,1139,03,06,-3
2013,1276,1433,04,05,-1
2013,1277,1272,03,06,-3
2013,1332,1387,12,04,8
2013,1393,1143,04,12,-8
2013,1455,1211,09,01,8
2013,1181,1166,02,07,-5
2013,1195,1361,15,07,8
2013,1196,1278,03,11,-8
2013,1231,1396,01,09,-8
2013,1242,1314,01,08,-7
2013,1247,1279,13,12,1
2013,1274,1228,02,07,-5
2013,1326,1235,02,10,-8
2013,1266,1274,03,02,1
2013,1326,1112,02,06,-4
2013,1393,1231,04,01,3
2013,1455,1247,09,13,-4
2013,1181,1277,02,03,-1
2013,1196,1195,03,15,-12
2013,1257,1332,01,12,-11
2013,1276,1242,04,01,3
2013,1393,1266,04,03,1
2013,1455,1326,09,02,7
2013,1257,1181,01,02,-1
2013,1276,1196,04,03,1
2013,1257,1455,01,09,-8
2013,1276,1393,04,04,0
2013,1257,1276,01,04,-3
2014,1107,1291,16,16,0
2014,1301,1462,12,12,0
2014,1142,1411,16,16,0
2014,1397,1234,11,11,0
2014,1163,1386,07,10,-3
2014,1173,1326,11,06,5
2014,1196,1107,01,16,-15
2014,1217,1153,12,05,7
2014,1257,1264,04,13,-9
2014,1276,1459,02,15,-13
2014,1277,1174,04,13,-9
2014,1295,1328,12,05,7
2014,1332,1140,07,10,-3
2014,1338,1160,09,08,1
2014,1361,1308,04,13,-9
2014,1387,1301,05,12,-7
2014,1393,1444,03,14,-11
2014,1400,1113,07,10,-3
2014,1437,1454,02,15,-13
2014,1458,1110,02,15,-13
2014,1112,1451,01,16,-15
2014,1124,1304,06,11,-5
2014,1166,1418,03,14,-11
2014,1211,1329,08,09,-1
2014,1235,1300,03,14,-11
2014,1242,1184,02,15,-13
2014,1246,1243,08,09,-1
2014,1272,1203,08,09,-1
2014,1273,1181,14,03,11
2014,1314,1344,06,11,-5
2014,1372,1433,12,05,7
2014,1390,1307,10,07,3
2014,1397,1269,11,06,5
2014,1417,1409,04,13,-9
2014,1438,1157,01,16,-15
2014,1455,1142,01,16,-15
2014,1163,1437,07,02,5
2014,1173,1393,11,03,8
2014,1196,1338,01,09,-8
2014,1257,1387,04,05,-1
2014,1276,1400,02,07,-5
2014,1277,1217,04,12,-8
2014,1361,1295,04,12,-8
2014,1458,1332,02,07,-5
2014,1112,1211,01,08,-7
2014,1124,1166,06,03,3
2014,1235,1314,03,06,-3
2014,1246,1455,08,01,7
2014,1390,1242,10,02,8
2014,1397,1273,11,14,-3
2014,1417,1372,04,12,-8
2014,1438,1272,01,08,-7
2014,1112,1361,01,04,-3
2014,1173,1390,11,10,1
2014,1196,1417,01,04,-3
2014,1458,1124,02,06,-4
2014,1163,1235,07,03,4
2014,1246,1257,08,04,4
2014,1276,1397,02,11,-9
2014,1277,1438,04,01,3
2014,1196,1173,01,11,-10
2014,1458,1112,02,01,1
2014,1163,1277,07,04,3
2014,1246,1276,08,02,6
2014,1163,1196,07,01,6
2014,1246,1458,08,02,6
2014,1163,1246,07,08,-1
2015,1214,1264,16,16,0
2015,1279,1140,11,11,0
2015,1173,1129,11,11,0
2015,1352,1316,16,16,0
2015,1112,1411,02,15,-13
2015,1116,1459,05,12,-7
2015,1139,1400,06,11,-5
2015,1153,1345,08,09,-1
2015,1207,1186,04,13,-9
2015,1209,1124,14,03,11
2015,1246,1214,01,16,-15
2015,1301,1261,08,09,-1
2015,1314,1217,04,13,-9
2015,1323,1318,03,14,-11
2015,1326,1433,10,07,3
2015,1412,1235,14,03,11
2015,1417,1374,11,06,5
2015,1428,1372,05,12,-7
2015,1437,1248,01,16,-15
2015,1462,1279,06,11,-5
2015,1173,1344,11,06,5
2015,1181,1352,01,16,-15
2015,1211,1295,02,15,-13
2015,1234,1172,07,10,-3
2015,1242,1308,02,15,-13
2015,1257,1414,04,13,-9
2015,1268,1434,04,13,-9
2015,1277,1208,07,10,-3
2015,1320,1461,05,12,-7
2015,1328,1107,03,14,-11
2015,1332,1329,08,09,-1
2015,1361,1385,08,09,-1
2015,1438,1125,02,15,-13
2015,1452,1138,05,12,-7
2015,1455,1231,07,10,-3
2015,1458,1157,01,16,-15
2015,1112,1326,02,10,-8
2015,1246,1153,01,08,-7
2015,1301,1437,08,01,7
2015,1314,1116,04,05,-1
2015,1323,1139,03,06,-3
2015,1417,1412,11,14,-3
2015,1428,1207,05,04,1
2015,1462,1209,06,14,-8
2015,1181,1361,01,08,-7
2015,1211,1234,02,07,-5
2015,1257,1320,04,05,-1
2015,1277,1438,07,02,5
2015,1328,1173,03,11,-8
2015,1452,1268,05,04,1
2015,1455,1242,07,02,5
2015,1458,1332,01,08,-7
2015,1112,1462,02,06,-4
2015,1246,1452,01,05,-4
2015,1323,1455,03,07,-4
2015,1458,1314,01,04,-3
2015,1181,1428,01,05,-4
2015,1211,1417,02,11,-9
2015,1257,1301,04,08,-4
2015,1277,1328,07,03,4
2015,1246,1323,01,03,-2
2015,1458,1112,01,02,-1
2015,1181,1211,01,02,-1
2015,1277,1257,07,04,3
2015,1181,1277,01,07,-6
2015,1458,1246,01,01,0
2015,1181,1458,01,01,0
2016,1195,1192,16,16,0
2016,1455,1435,11,11,0
2016,1221,1380,16,16,0
2016,1276,1409,11,11,0
2016,1114,1345,12,05,7
2016,1139,1403,09,08,1
2016,1163,1160,09,08,1
2016,1181,1423,04,13,-9
2016,1211,1371,11,06,5
2016,1231,1151,05,12,-7
2016,1235,1233,04,13,-9
2016,1242,1122,01,16,-15
2016,1246,1392,04,13,-9
2016,1274,1138,03,14,-11
2016,1314,1195,01,16,-15
2016,1344,1425,09,08,1
2016,1428,1201,03,14,-11
2016,1438,1214,01,16,-15
2016,1455,1112,11,06,5
2016,1463,1124,12,05,7
2016,1218,1143,13,04,9
2016,1234,1396,07,10,-3
2016,1268,1355,05,12,-7
2016,1292,1277,15,02,13
2016,1320,1400,11,06,5
2016,1323,1276,06,11,-5
2016,1328,1167,02,15,-13
2016,1332,1221,01,16,-15
2016,1372,1452,14,03,11
2016,1386,1153,08,09,-1
2016,1393,1173,10,07,3
2016,1401,1453,03,14,-11
2016,1433,1333,10,07,3
2016,1437,1421,02,15,-13
2016,1458,1338,07,10,-3
2016,1462,1451,02,15,-13
2016,1181,1463,04,12,-8
2016,1211,1428,11,03,8
2016,1231,1246,05,04,1
2016,1235,1114,04,12,-8
2016,1242,1163,01,09,-8
2016,1274,1455,03,11,-8
2016,1314,1344,01,09,-8
2016,1438,1139,01,09,-8
2016,1268,1218,05,13,-8
2016,1323,1372,06,14,-8
2016,1328,1433,02,10,-8
2016,1332,1386,01,08,-7
2016,1393,1292,10,15,-5
2016,1401,1320,03,11,-8
2016,1437,1234,02,07,-5
2016,1458,1462,07,02,5
2016,1242,1268,01,05,-4
2016,1328,1401,02,03,-1
2016,1332,1181,01,04,-3
2016,1437,1274,02,03,-1
2016,1314,1231,01,05,-4
2016,1323,1458,06,07,-1
2016,1393,1211,10,11,-1
2016,1438,1235,01,04,-3
2016,1328,1332,02,01,1
2016,1437,1242,02,01,1
2016,1314,1323,01,06,-5
2016,1393,1438,10,01,9
2016,1314,1393,01,10,-9
2016,1437,1328,02,02,0
2016,1437,1314,02,01,1
